|----------------|
|                |
|      UP        |
|                |
|-----|  |-------|
      |  |
      |  |
|-----|  |-------|
|                |
|    Starting    |
|     Room       |
|----------------|
